0111111111111111111111111111111111111111111111111111111111111111111111111111112
3444444444444444444444444444444444444444444444444444444444444444444444444444445
3444444444444444444444444444444444444444444444444444444444444444444444444444445
3444444444444444444444444444444444444444444444444444444444444444444444444444445
3444444444444444444444444444444444444444444444444444444444444444444444444444445
3444444444444444444444444444444444444444444444444444444444444444444444444444445
3444444444444444444444444444444444444444444444444444444444444444444444444444445
3444444444444444444444444444444444444444444444444444444444444444444444444444445
3444444444444444444444444444444444444444444444444444444444444444444444444444445
3444444444444444444444444444444444444444444444444444444444444444444444444444445
3444444444444444444444444444444444444444444444444444444444444444444444444444445
6777777777777777777777777777777777777777777777777777777777777777777777777777778